{
  "chompers": [
    { "x": 350, "y": 900 },
    { "x": 1130, "y": 900 },
    { "x": 1230, "y": 900 },
    { "x": 4669, "y": 874 },
    { "x": 6765, "y": 415 }
  ],
  "flowers": [
    { "x": 1420, "y": 528 },
    { "x": 2926, "y": 590 },
    { "x": 3886, "y": 880 },
    { "x": 5228, "y": 720 },
    { "x": 8189, "y": 975 },
    { "x": 8559, "y": 975 }
  ],
  "skeletons": [
    { "x": 2051, "y": 757 },
    { "x": 5358, "y": 891 },
    { "x": 5495, "y": 870 },
    { "x": 7196, "y": 477 },
    { "x": 9325, "y": 603 }
  ],
  "flyflys": [
    { "x": 3341, "y": 581 },
    { "x": 6328, "y": 543 },
    { "x": 7628, "y": 523 },
    { "x": 8110, "y": 481 }
  ]
}
